/////######/////////
////##    #/////////
////##$   #/////////
//####   $#/////////
//##  $ $ #/////////
#### # ## ##########
##   # ## #####  ..#
## $  $          ..#
###### ### #@##  ..#
////##     #########
/////########/////// 